0xxxxxxxxx0xxxxxxxxx
0000000x0x0000000x0x
x0xx0x0x00x0xx0x0x00
x0000x000xx0000x000x
xx0xxxxx00000xxxxx0x
x00000000xx00000000x
x0x0xxx0xxx0x0xxx0xx
x0x000x00000x000x000
x000x000xxx000x000xx
xxx0xxx000xxx00xx000
0xx0xxxxxx0xxx0xxxxx
0000000x0x0000000x0x
x0xx0x0x0000xx0x0x00
x0000x000xx0000x000x
xx0xxxxx0xxx0xxxxx0x
x00000000xx00000000x
x0x0xxx0xxx0x0xxx0xx
x0x000x00000x000x000
x000x000xxx000x000xx
xxxxxxx000xxxxxxx000